#########################
#   #       #           E
#   #       #           #
#   #       #           #
#   #####   #   #####   #
#           #       #   #
#           #       #   #
#           #       #   #
#####   #####   #   #   #
#   #           #   #   #
#   #           #   #   #
#   #           #   #   #
#   #   #############   #
#       #       #       #
#       #       #       #
#       #       #       #
#   #   #   #########   #
#   #               #   #
#   #               #   #
#   #               #   #
#####   #########   #   #
#           #       #   #
#           #       #   #
#R          #       #   #
#########################