###############################
#        #        #  #        E
#        #        #  #        #
#  ####  ####  ####  #  #######
#  #        #        #        #
#  #        #        #        #
#  ####  #######  ####  #######
#  #  #              #        #
#  #  #              #        #
#  #  #  ##########  #  ####  #
#  #           #           #  #
#  #           #           #  #
#  #  #  #  #  #  #######  ####
#  #  #  #  #  #     #        #
#R #  #  #  #  #     #        #
###############################