##############################################
#                   #    #                   E
#                   #    #                   #
#                   #    #                   #
#                   #    #                   #
###########    #    #    ###########    ######
#         #    #    #    #         #         #
#         #    #    #    #         #         #
#         #    #    #    #         #         #
#         #    #    #    #         #         #
#    ######    ######    #    #    #    #    #
#                   #         #    #    #    #
#                   #         #    #    #    #
#                   #         #    #    #    #
#                   #         #    #    #    #
######    #    ###########    #    #    ######
#         #         #         #              #
#         #         #         #              #
#         #         #         #              #
#         #         #         #              #
######    #    ######    ###########    #    #
#         #    #         #    #         #    #
#         #    #         #    #         #    #
#         #    #         #    #         #    #
#         #    #         #    #         #    #
######    #    #    ######    #    ######    #
#    #    #         #    #         #    #    #
#    #    #         #    #         #    #    #
#    #    #         #    #         #    #    #
#    #    #         #    #         #    #    #
#    #    ######    #    #    ######    ######
#              #    #    #              #    #
#              #    #    #              #    #
#              #    #    #              #    #
#              #    #    #              #    #
###########    ######    #    #    #    #    #
#                   #         #    #         #
#                   #         #    #         #
#                   #         #    #         #
#R                  #         #    #         #
##############################################