#############
#           E
####### # ###
#   # # #   #
### # # # ###
#       #   #
####### ### #
# #       # #
# # ####### #
# # #   #   #
# # # # # ###
#R    # #   #
#############